11111111111
1111C0000C1
1M000C11001
1M000111001
1P0011011E1
11111111111




   
