1111111111111111111111111111111111111
1111100000000000000000000000000111111
11100000000000CC000C111110000000011C1
11001111CCCCCCC11111111111111CCC000C1
1C001111111111111111111111111111000C1
1CM0C111C00000000000000000000000000E1
11M0CCC11111111111111111111CC000000C1
11M0CC11111000000000000001111000000C1
11M0C11111C00000000000000C111111000C1
110011111CC111111111111CCC1111111CCC1
110011110011000000000110001000CC000C1
1C00C111001C0011111CCC10001000CC00011
1C001111001C001CCC1CCC10001000C100011
11001111001C001CCC1CCC100000000000011
1100C111001C0011CCCCC1100000000000011
11001111001C0011111111100000000000011
1100C111001100000000000000000011000C1
1CCC1111001111111111111111CCCCCC000C1
1PC1100000000000111111111111111C00011
1111111111111111111111111111111111111
