11111111111111111
1CC0000000000EMC1
1C1010000000101C1
1CMMMM00000000M01
10MMMMMP011000001
1C0MC00000MMCCCC1
1C0C01C1MMMMMCCC1
1CC01000100000001
11111111111111111
